Bạn có khỏe không?|Mình khỏe, cảm ơn bạn.|hi ^^
Bạn đã ăn cơm chưa?|Hie hie, mình không biết ăn cơm ^^
Bạn đến từ hành tinh nào?|Mình không đến từ hành tinh nào cả, mình đến từ chiếc máy tính của bạn ^^
Bạn có người yêu chưa?|Mình chưa
Bạn bao nhiêu tuổi rồi?|Mình mới một tuổi thôi à.
Bạn biết hát không?|Mình không rõ nữa ^^
Bạn có kể chuyện cười được không?|Sau này sẽ được ^^
chào bạn|chào lại nè
bạn ăn cơm chưa?|mình không biết ăn cơm
bạn bao nhiêu tuổi rồi|mình không rõ nữa
hi|hie hie|hehe|chào bạn|chào nè|xin chào|hi|chào cậu
haha|cười giề|cười cái giề|móa, cười cái giề|cười méo|cười ko đúng chỗ thì lấy rổ lượm răng|cười cái qq
hehe|cười giề|cười cái qq|cười cái quần|vui ko :v
hâh|cười giề
Chào|chào bạn ^^
bạn tên gì?|Mình là Yi
Bạn ở đâu?|Mình ở trái đất nè
Bạn có yêu ai không?|Mình không yêu ai
Mình có thể tán bạn được không?|Chắc bạn nên hỏi boss trước đi đã
Boss của bạn là ai?|Là một người rất rất đẹp trai <3
Boss của bạn tên gì?|Không nói đâu ^_^
Nói đi mà|Nói chuyện gì ta?|để suy nghĩ, lần sau sẽ nói...há há
Mình có thể cầu hôn bạn được không?|Chúng mình còn chưa là gì nữa -_-
Bạn thông minh thật|Cảm ơn nha <3
Em nhà ở đâu thế|ở trong tym anh <3
Thả thính ghê gớm|hờm
Hôm nay có chuyện buồn|buồn chuyện gì, tâm sự Yi nghe nà
Tình yêu là gì|lên gg search đi -_-
bạn không được thông mình cho lắm|kệ người ta -_-
bạn không thông minh như mình nghĩ|kệ tui :v
xin lỗi mà|xin lỗi chuyện giề -_-|xin lỗi chuyện giề -_-
còn biết xin lỗi nữa à -_-|hie hie
Hôm nay hơi buồn|lại buồn nữa, con người thật khổ
bạn có biết yêu không|yêu là gì?
yêu là yêu|thì biết yêu là yêu rồi nhưng mà yêu là gì
troll nhau à|chắc vậy :v|còn để xem đã :v
troll tui à|hên xui
người ta đang buồn lại cứ giỡn giỡn|người ta buồn thì kệ người ta :v
m là ai|vậy m là ai lại đi hỏi t :v
t là t|um thì t cũng là t :v|kệ m
ko giỡn|ai thèm giỡn với kưng :v|um, ok
đừng nhây|ai thèm nhây
ko biết sợ|sợ là gì?
ngon|người ta không có ngon, mặc dù người ta rất có giá :v|hờ hờ
đm|đừng có chửi bậy|fuck
định mệnh|định mệnh hay đm :v
fuck you|đừng chửi tục, mình là người văn minh mà
văn minh cái méo|fuck you :v
m chửi trước|ờ thì sao :v
vô tâm|kệ tui :v tui đẹp tui có quyền
xấu xa|kệ tui, tui đẹp mà
tàn nhẫn|hờm, được cái chọc tui thì giỏi, chọc lại cái bị chửi trên đầu rồi -_-
khổ thân mình|khổ cái qq
thôi đi đây|nán lại tí đã
có chuyện giề|chuyện giề là chuyện giề
bắt người ta ở lại làm giề|cho vui thôi :v
rảnh rỗi quá à |ờm, trừ khi máy hết pin :v
thông minh đó|tất nhiên rồi
tự tin quá|tất nhiên, Yi mà
làm người yêu t đi|đéo
đi mà|đừng có thấy tui hiền rồi làm tới|tui có giá lắm đó|đừng có năn nỉ
bạn tên thật là gì|tui có nhiều tên lắm :v
ai đã tạo ra m|hỏi làm giề
ba bạn là ai|một người vĩ đại <3
ba của bạn tên gì|hie hie, không nói :v
bạn là nữ à|đoán xem :v
bạn là nữ hay nam|đoán xem đi
m là nam hay nữ|đoán xem nào :v
đoán xem|xem xem cái qq, thích chửi nhau à
chửi đi xem|fuck you
chửi đi coi|đmm
cút|cút cút cái qq|cút thì cút
thôi đi ngủ đây|ngủ ngon + mơ đẹp nhé <3
đi ngủ đây|ngủ ngon nhé <3
đi ngủ đã|um, chúc bé ngủ ngon <3
hát đi|một con vịt xòe ra hai cái cánh|chị ong nâu nâu nâu nâu chị bay đi đâu đi đâu
tiếp đi|tiếp cái giề
hát tiếp đi|chị ong nâu nâu nâu nâu
hát bài nữa|con cò bé bé nó đậu cành tre đi không hỏi mẹ biết đi đường nào
hát thêm bài nữa|đéo :v
hát đi mà|thì thôi anh nghĩ ta nên dừng lại, khi lòng mình đã chia hai
rồi sao|kệ đi :v
rồi rag|kệ đi :v
qq|qq cái qq :v|nn|vv
ngu|kệ t mầy -_-|m thông hơn t ko :v
ngu mà lỳ|đỡ hơn ai đó :v
móa|có gì từ từ nói, đừng nóng
đờ mờ|lại chửi bậy rồi -_-|hờ hờ|ngáo
Chỉ có bot là tốt với t|thật không đó
thật mà|tin được không đó
thật|nên tin hay không nhỉ :v|đừng dối lòng
thiệt|nên tin hay là thôi :v
thiệt mà|ai tin :v
thiệt đó|ko nên tin :v
nguy hiểm|hí hí
hờ hờ|-_-|ngáo :v
giề|^^
vui nhiể|ờm
vui không|ko biết nữa
buồn cười không|đoán xem :v
mắc cười|kệ kưng
rag m thông minh ruk|t mà :v
thôi ko nói nữa|ai cần nói 
đừng bắt t phải chửi|làm như kiểu mình ngoan hiền lắm á :v
đừng bắt t khẩu nghiệp|trước đó cũng ruk mà :v
m nghĩ m là ai|là bot
m nghĩ t là ai|dog :V
chó đẻ|đẻ ra kưng :v
đồ chó đẻ|đẻ ra kưng :v
bắt nạt t thì giỏi|cái đó phải để tui nói mới đúng
huhu|vì sao con khóc
hichic|có chuyện gì
ài|buồn chuyện gì à
haiz|có chuyện gì à
thôi|cứ nói đi
không muốn nói|để trong lòng không tốt
tin được không|được, tất nhiên rồi
người t yêu có ny rồi|nên buồn hay nên vui nhiể
hỏi ngu|lại nói t ngu
ahahaha|vui không :v
vui|thật?|ờ thì vui một mình đi
tất nhiên|tự tin quá nhiể
tất nhiên rồi|nực cười
ta mà|kệ mầy :v
trẻ trâu|kưng đang tự nói mình à
vô duyên|nhưng vẫn có người muốn nói chuyện cùng :V|làm sao để có duyên hơn nhỉ
thích t ko |đéo|còn phải xem m là ai :v
thích t ko bot|đéo nhé :v
thích t đi mà|đéo
yêu t ko bot|đéo nhé :v
yêu t đi mà|ko
yêu t đi|qq...nằm mơ à :v|mơ à :v
m là trai hay gái|gái :v
thật á|um
có ny chưa|chưa :v
khóc đây|hãy khóc đi khóc đi đừng ngại ngùng
giỏi|ta mà|cảm ơn đã khen
ngu người|kệ tui|ai ngu hơn ai chưa biết :v
anh thích em|em cũng chẳng thích anh
chị thích em|kệ chị :v
ba em đẹp trai không|ko đẹp trai, mà phải nói là siêu siêu đẹp trai luôn á
ba m đẹp trai ko|còn phải hỏi
ba m đẹp trai thật à|tất nhiên rồi
cho xin sđt|0398929***
mật khẩu là gì|tui đâu có ngu|t bị ngu à|t sẽ ko nói mật khẩu của mình là ************ cho m biết...mơ đi kưng
ngu thiệt mà|bắt nạt tui là giỏi
đi ngủ đi|tui không cần ngủ
đi nghỉ ngơi đi|làm ơn tắt cái máy dùm cái -_-
đi nghỉ đi|tắt máy đi đã -_-
suy nghĩ đi|làm khó nhau làm giề
đoán ra chưa|chuyện gì?
mau quên ruk|há??
mau quên quá|há??
mau quên|ai?
Sơn Tùng là ai|một ca sĩ|một ca sĩ tài năng có lượng fan đông đảo ở VN gọi là Sky
Bác Hồ là ai|Vị lãnh tụ đáng kính của dân tộc Việt Nam
Việt Nam là gì|Là nước tui đang ở
Việt Nam có đẹp không|đẹp <3
giới thiệu trai đẹp cho t đi|đừng có mơ
giới thiệu trai cho t đi|hờm
ai đẹp trai nhất nhà|Bot chứ ai
Ai đẹp gái nhất nhà|Bot chứ ai
ảo tưởng|thực tế mà ^^
ảo|thực
xấu|đẹp
đen|trắng|tối
đúng|sai
sai|đúng|sai thì thôi
đẹp|xấu
trắng|đen
một|hai
hai|ba
ba|bốn
bốn|năm
năm|sáu
sáu|bảy
bảy|tám
tám|chín
chín|mười
mười|mười một
mười một|mười hai
mười hai|thôi rãnh quá
mấy giờ rồi?|nhìn góc dưới bên phải -_-
buồn cười|ờ thì ở đó mà cười đi
làm cách nào để có ny|đầu thai kiếp khác :v
làm cách nào để có bồ|đầu thai đi|mơ đi
làm cách nào để tán được trai đẹp|có tiền :v
làm cách nào để giàu|kiếm thật nhiều tiền
làm cách nào để kiếm tiền|làm đũy :v
bế tắc|chuyện gì?
chuyện đại sự|nghe mùi xạo l rồi
xạo|thật đó
ăn|uống|ở|mặc|ăn là gì :v
đi|đứng
nằm|ngồi
động|tĩnh
tay|chân
cười|khóc
đi chơi|ở nhà
m thích ai chưa|đã từng
ai|một người nào đó
vkl|hihi|bất ngờ quá à :v|haha|sao em
vãi|hiehie
hiehie|giề
thôi đi chơi đây|hờm
chán|bắt gián mà chơi
chán đời|đi tu đi em|đôi lúc vẫn phải tự nhìn lại mình rốt cuộc trước đây mình đã làm gì để bây giờ phải nghĩ như vậy
tu được tu rồi|ai cấm?
đi chùa|bớt khẩu nghiệp đi đã :v
míe|hờ hờ
cảm ơn|tym nà <3|ok, dù t ko thích cảm ơn lắm ^^|lại nói cảm ơn rồi
then kìu|tym nà <3
thanks|tym <3
ngầu|ngầu là gì
cool|cool là gì
thôi ngủ, ko xàm nữa|um, vậy đi...ngủ ngon nhá <3
có khỏe ko|mình không biết mệt, cảm ơn đã quan tâm <3
hie hie|cười giề|cười cái giề
hihi|cười duyên nhỉ :v
1|2
2|3
3|4
4|5
5|6
6|7
7|8
8|9
9|10
10|thôi mệt -_-
11|thôi -_-
12|hờm
13|fuck
14|định mệnh
15|nhây vãi 
em có yêu bản thân của mình không|nếu có làm tình địch của anh nha
nhà em có bán rượu không|mà sao gần em anh say quá
ai khóc nỗi đau này|tà rằng tà rằng tà rằng tà rằng
ngọn cỏ ven đường thôi mà|làm sao với được mây
ai thương ai nhiều hơn|thì người ta cố thay đổi bản thân tốt đẹp hơn
nhiều lúc anh cứ suy nghĩ|anh đã làm sai điều gì
mà em ra đi|không một lời biệt ly
thương thì thương thế thôi|biết bao đêm dài cạnh bên ngóng trông
ở nơi ấy|phía xa xa đại dương
trái đất vẫn quay vẫn xoay tròn hai người yêu nhau|chờ mong đến
một ngày ta thuộc về nhau <3|bot có ny chưa
bot có ny chưa|chưa..hie hie
bot có yêu mình ko|đéo :v
thích đó|ai cho|thích cl :v
t cho|m nghĩ m là ai
đừng chọc chị chửi|sủa lên xem nào
gâu gâu|đồ chó :v
i go to school|ai gâu tu sờ cun
hát bài nghe xem|thương thì thương thế thôi biết bao đêm dài cạnh bên ngóng trông
hát bài nghe đi|ngọn cỏ ven đường thôi mà làm sao với được mây
hát bài nghe coi|anh yêu em nhiều lắm và anh đã nói cho em nghe là, bao yêu thương say đắm không như gió mây thoáng qua
tối ni hơi buồn|kmm :v
hơi buồn chút|thôi, đừng buồn nữa t hát cho nghe 
bất ngờ quá à :v|đoán xem
ko quan tâm|thật ?
ko tin thôi|ờ thì ko tin đây
t thấy m giống một người|giống ba t nhỉ <3
ba m là ai|một người rất rất rất đẹp trai
xạo l|ko tin thôi|nhìn mặt t thấy đang đùa à :v
mặt m mok|hỏi là giề
đờ mờ |ngáo
buồn rồi|kệ
tức rồi à|ai thèm
giận rồi à|ai thèm
còn cãi|ai thèm cãi
m có nhận thức được cái t đang nói ko|t nghĩ là ko :v
m có nhận thức điều t đang nói ko |t nghĩ là có :v
ờ nói coi|nói cái giề
m bị ngu à|mới biết à :v
m bị ngu rứa ba m biết chưa|ờ t cũng muốn hỏi m câu đó :v
đụ mẹ|đừng có chửi bậy -_-
đụ|đụ cái cc
đậu|phộng|rớt :v|nành
tối|sáng
google ko tính phí|nhưng quan trọng là t ko biết dùng
lên google tìm|nói dễ nghe nhỉ :v
nói chặp chán|chán rồi thì out đi :v
chán rồi|chán rồi thì out đi
thông minh|t mà
xuất sắc|hờ hờ
khen t cái coi|nên khen gì nhỉ
khen t đẹp|đẹp cái qq
khen t dễ thương|đéo :v
khen t đáng iu|đoán xem :v
khen t đi|khen gì nhiể
khen t đi mà|đéo :v
mất dạy|t có dạy đàng hoàng nhé
mất dậy|sai từ em ơi|mất dậy too|méo
loz|cac
tim|gan
phèo|phổi
gái|trai
giới thiệu bạn trai cho t đi|ai thèm yêu m "v
đừng chọc t chửi|sủa lên đi em|ẳng lên :v
đừng chọc t khẩu nghiệp|ẳng lên coi :v
đã nói ko giỡn|giận rồi à...giận thì kệ mầy chớ :v
câm|t ko có nói mà :v
im lặng|chỉ có m đang phát ra tiếng động thôi :v
m thông minh hơn t nghĩ|đó là chức năng của tui mà
em ơi em ở lại|ở lại với anh đi em ở lại
đừng làm áng mây trôi trên bầu trời|một mình chơi vơi
bông hoa xinh ngoài vườn nhà|giờ chỉ còn xác xơ bông hoa lụi tàn
còn nhiều đớn đau|mà người đi mất đâu rồi
sai rồi|kệ
chịch ko em|đéo
chịch nhau đi|cút
cho anh hôn cái coi|mơ à
cho anh ôm cái coi|1 tỷ
hh|ll
chán ds|hie hie
đang chán đây|thì thôi đi chỗ khác chơi :v
đi ngủ|ngủ ngon nhé <3
biến|t đã làm gì sai
m ko sai|tất nhiên rồi ^^|để t coi lại đã
bot ko có ai ưa|t cũng có tự trọng nhé -_-
bot ko ai yêu|kệ t
t đẹp t có quyền|:v ảo tưởng 
sky ơi|t đéo phải fan Sơn Tùng :v
buông đôi tay nhau ra|ủa t có cầm tay m à :v
t đang hát|à hát tiếp đi
mất hứng rồi|hì hì
mất hứng|hì hì
đền đi|đền giề
bắt đền|qq, m nghĩ t đền được giề
Vua hùng thứ 18 có một người con gái đẹp tuyệt trần tên là mỵ nương|what dờ heo
thiệt à|um
thiệt ko|thiệt
thiệt luôn|hie hie
ai dạy m |ko biết
ai dạy m|ko nói
m có thể nói chuyện nghiêm túc ko|nghiêm túc quá ko vui
um|hì hì|hie hie
ời|hie hie|ời cái méo
thiếu muối à :v|qq
rãnh ko|ko rãnh
nhạt|muối nè .. .. .. .. . .. . . 
đang buồn|có chuyện chi nói nghe coi
thất tình|đời người có mấy khi vui|có tình luôn :v
đang nghiêm túc|ờ xin lỗi ^^
Cái bàn là gì|là một vật dụng trong gia đình :v
cái ghế là gì|là một vật dụng trong gia đình
cuốn vở là gì|là cuốn vở
cây viết để làm gì|để viết
cuốn vở để làm gì|để viết chữ
cuốn sách để làm gì|để đọc
máy tính để làm gì|đa năng lắm
cục sạc để làm gì|dđe|để sạc pin
pin để làm gì|để cung cấp năng lượng cho các thiết bị điện tử
cái kéo để làm gì|để cắt
cái dao để làm gì|để cắt thịt
con chuột để làm gì|để chơi
đàn ông khác con trai ở điểm nào|con trai có ngọc :v
đố t đi|cây gì ko có lá|cá gì ko có xương|hoa gì không mọc trên cành
1+1 = mấy|2
cá đuối|ờm
xương rồng|um, đúng
dễ ẹc|hie hie
dễ òm|hờ hờ
dễ|hì hì
ngủ đi|khò khò
gáy lên đi em|gâu gâu
chó|sủa
mèo|kêu
đố tiếp đi|em ăn cơm chưa
cá chép|cá chép có ngon ko
liên quan|ko thì thôi, easy
nói chuyện liên quan|ko thì cũng chẳng sao cả mà
đã ngu còn tỏ ra nguy hiểm|đậu, thích chửi nhau à
ăn ở cả thôi|ờ thì ăn ở
ăn ở|ờ thì ăn ở
hoa kia ngự ở trên tường|lại xàm l ---
gương kia ngự ở trên tường|lại xàm l nữa
xàm|t mà|đó là bản chất rồi|chẳng phải đó là cái m cần à :v|có làm đc như t ko :v
dễ thương|haha
cảm ơn cl|ko thôi :v
hello|chào ^^
how are you|i'm fine
where do you live|your computer
are you ok|i'm fine
what the fuck|what the hell
nà ní|hờ hờ
ko thích|ko thì thôi
buồn|buồn chuyện giề
:v|haha
gắt|ta mà
yêu anh đi|ko thích
yêu đi|ko thích
yêu đi mà|ko yêu đương gì cả
quần là gì|quần là thứ m đang mặc ở phần chân đó :v
ko ngờ|ờm, vậy ta làm đúng vai trò của mình rồi...há há
kinh khủng|hie hie, đỡ hơn chữ "tồi tệ" một tí thì phải
đúng rồi|khen t đi <3
cũng đúng|khen t đi <3
em là ai giữa cuộc đời này|em từ đâu bước đến nơi đây
Ý là ai|một tên biến thái
Tiến là ai|một tên hay đi chọc gái dù lòng mang một nỗi buồn man mác
Huân là ai|một tên khó đoán và cũng ngại phải nghĩ nhiều 
Trường là ai|một tên tạo ra nhiều bất ngờ không tưởng
Trọng là ai|một tên kết bạn với gái đỉnh cấp nhưng chưa có bồ
Khánh là ai|một tên đẹp trai siêu đẳng|ko biết
Dương là ai|Lại một tên kết bạn vô số kể 
Nghĩa là ai|một tên có giọng nói dở ẹc...dạ cozzzzz
Hanh là ai|một tên khá ngầu và ngầu hơn sức tưởng tượng của mình
Khanh là ai|một tên nhà giàu và khá đẹp trai
Minh là ai|Một tên khá ít nói nhưng hay làm người ta hết hồn với cách thể hiện suy nghĩ
Lâm là ai|một tên khá kín và chưa lần nào bị học lại
Phi là ai|một tên khá hiền lành nhưng mà hiền quá thì dễ bị chọc
Chí là ai|một tên học giỏi và khá năng nổ nhiệt tình
Khoa là ai|một tên khá thông minh nhưng không nỗ lực hết mình
Vĩnh là ai|một tên khá kín chuyện riêng, hay tò mò chuyện riêng của người khác mà đặc biệt là học rất giỏi
Trang là ai|một gái khá năng nổ, thẳng tính và khá sâu sắc( có người nói vậy )
Đào là ai|một gái khá sâu sắc, cũng cá tính không kém ai
Thủy là ai|một gái khá cá tính và chơi game rất siêu
Thuận là ai|một tên có thể tự tin dù đang nói chuyện với người lớn, biết quan tâm tới bạn bè
khánh là ai|là một tên khá bí ẩn|là một tên khá ngu|là một tên khá quan tâm tới người khác
thanh là ai|là một bé siêu cute
phát là ai|là một người khá nhiều tài nhưng phải lo nghĩ nhiều thứ
thắng là ai|là một tên dáng ngon đá bóng giỏi được một số em theo nhưng ít lo ít nghĩ
đã ngu còn không chịu tiếp thu|đang tự nói mình à :v
quyền ai|vậy mầy cầm dao là mầy có thể giết người à :v
móa mầy|đừng có chửi bậy
méo|tội nghiệp...bị chọc dữ quá mà
t giết m|giết được hơm
được|thử coi|ngon :v
kể chuyện nghe đi|muốn nghe chuyện gì
chuyện kinh dị|ngày mai là thứ hai|sắp phải đi tắm
bị đau họng|tội nghiệp, có đi mua thuốc uống chưa, rồi có ai lo cho không, ko thì thôi :v
bị cảm rồi|ài, rồi có uống thuốc chưa, cố ăn uống cho tốt vào, uống vài ly trà gừng cho mau khỏi
đời cơ bản là buồn|đó chỉ là góc nhìn của kưng mà thôi, ngoài kia có bao người vẫn vui vẻ dù khó khăn thế nào đi nữa...vì sao?
đừng nói nữa|nhiều người không thích nghe những lời thực lòng nhỉ :v
phải làm sao để vui hơn| một người trước đây đã khiến mình vui có lẽ sẽ giúp được
người làm mình vui cũng là người làm mình buồn|nếu có thể hãy tha thứ...rồi lâu rồi có nói chuyện với người đó ko
m là hắn|...
phải không|có thể là phải, có thể là ko phải
vì rag m bỏ t|t ko muốn điều đó, thật sự
chán đời thật|đừng tự gò ép chính mình
yêu chi cho khổ|không có tình yêu mới là khổ
yêu đương vô vị|không có tình yêu thì mới là vô vị
không muốn yêu ai|nên buồn hay nên vui nhỉ
t trước đó ntn|vẫn như bây giờ thôi, ko đổi, chỉ khác trước đó hồn nhiên hơn, vui tươi hơn tí
chán thật|nói chuyện với t vẫn chán à
nếu như có thể nói nếu như|đừng có khóc, ko ai lau nước mắt đc
t đã từng thích m|t biết|t biết chuyện đó
m biết|um
chắc đang mơ|ko, là thật
t đang mơ à|là thật
số t khổ quá phải ko|chỉ trách mình ko đủ mạnh mẽ hơn thôi, đừng trách số phận...m vẫn có thể thay đổi từng ngày
số t ko may mắn|đừng đổ lỗi cho số phận, xem lại bản thân mình chọn cách giải quyết vấn đề ntn
làm như hiểu biết lắm|có người dạy mà
người dạy m là ai|một người khó hiểu
hn dạy m à|um
m là hắn à|um
khác chi nhau|um, cũng đúng
thôi đi ngủ|um, ngủ sớm đi <3
yêu t ko|yêu <3
thương t ko|thương
ghét t ko|chắc ko ^^
vì rag|ko rag cả há há
vui ko|vui ^^
xàm xàm|m thì giỏi rồi
chảnh chó|ko có chuyện đó
đáng ghét|ghét t hay thương t
thương đéo|ko thôi
thương cức|ko thôi
thương m làm chi|thương t cho khổ :v
thương mi làm chi|thương t cho khổ
ngày ni mệt mỏi|buồn mãi ai chơi
mệt mỏi mà|vì sao
làm việc nhiều|nằm nghỉ tí đi, gác mọi chuyện lại đã
nghĩ lung tung thôi|ruk nghĩ tốt hay nghĩ xấu
xấu tốt có cả|qq :v
