i love you|master yêu alex|master love alex|wo ai ni|ngộ ái nị|tiamo|sa-rang-hae-oh
ai nói|ai bảo|ai nhủ
ân đức|ân huệ|ơn đức|ân nghĩa|ơn nghĩa|ân tình|ơn tình|ơn huệ
ân cần|tha thiết|thiết tha
ẩm mốc|ẩm ướt|ướt át|ẩm thấp
ác độc|ác đức|ác hiểm|ác nghiệt|bạo ngược|bạo tàn|bất lương|cay nghiệt|độc ác|hung ác|hung bạo|hung dữ|hung tàn|tàn bạo|tàn ác
bạn bè|bằng hữu|bè bạn
bên mình|bên ta|phía ta|phía mình|quân ta|đồng minh
bận rộn|bận bịu
bao la|bát ngát|mênh mông|rộng lớn
bà xã|hiền thê|vợ yêu
bình thường|tầm thường|thông thường|đơn giản|giản đơn
bình tĩnh|an tĩnh|điềm tĩnh|thong thả|thư thả|từ tốn
bình an|yên ổn|an bình|an toàn
bình dân|dân dã
bất định|biến động
bất chính|bất lương|gian tà|phi pháp|trái pháp luật|trái phép
biệt ly|ly biệt|chia phôi|ly tán
bi thảm|bi thương|thảm thương|bi ai|bi đát|bi lụy|âu sầu|thảm não|não ruột|sầu lòng|sầu tư|não nề|não nùng|u sầu|thê lương|ưu phiền
buồn bực|buồn phiền|buồn chán|phiền muộn|buồn rầu|phiền não|buồn bã
buồn tẻ|buồn tênh|buồn rười rượi|buồn thiu|chán ngắt
bi quan|tuyệt vọng|vô vọng|sầu thảm
bị động|thụ động
buồn tình|thất tình|sầu thương|sầu lòng
bí mật|secret|tuyệt mật
ba hoa|bịa đặt|bịa chuyện|nói sảng|bóp méo sự thật|đặt điều|nói dối|nói điêu|nói khoác|bốc phét|nói láo|nói trạng|trạng lồi|nói xạo|dối lừa|lừa dối|lừa đảo|khoác lác|dối trá
bừa bãi|bừa bộn|lộn xộn
bạc tình|bạc bẽo|bạc nghĩa|bội bạc|tệ bạc|vô ơn|phụ bạc
bất công|thiên vị|không công bằng|ko công bằng
bây giờ|hiện tại|hiện nay|ngày nay
bè đảng|bè pháp|bè lũ
bé xíu|bé tí|nhỏ bé|nhỏ nhặt|tí hon|vụn vặt|nhỏ nhoi|tí xíu|vụn vặt
bậy bạ|nhăng nhít|tầm bậy|tầm phào|nhảm nhí|càn rỡ
bỏ nhau|li dị|ly hôn|đường ai nấy đi|chia tay
bỏ bê|bỏ mặc|mặc kệ|không ngó ngàng|ko để tâm
cái ni|cái này
cứng đờ|cứng ngắt|cứng ngắc
cứng rắn|cứng cáp|cứng nhắc|cứng nhắt
chen chúc|chi chít|dày đặc|đặc kịt
ca ngợi|khen ngợi|khen thưởng|khen
chuyện ni|chuyện này
cẩu thả|chây lười|lười nhác|biếng nhác|làm biếng|chểnh mảng|nhác nhớm|qua loa|qua quýt
chăm chỉ|cần mẫn|cần cù|chăm làm|chăm học|siêng năng|chuyên cần
cao thượng|cao đẹp|cao cả|cao đạo
cổ kính|cổ đại|cổ điển|cổ xưa|cũ kỉ|cũ rích|cũ kỹ|cũ mèm
cống hiến|đóng góp
cao quý|cao sang|thượng đẳng
căn bản|chủ chốt|chủ yếu|cốt ít|chính yếu|chủ đạo|cơ bản
cao thâm|cao tay|cao siêu
cố tình|cố ý
cái chi|cái gì|cái nào|cái giề
cười cợt|cười duyên|cười khẩy|cười nhạt|cười nịnh|cười trừ
cách chi|cách gì|cách nào
cách biệt|cách ngăn|cách chia|ngăn cách|cách trở|cách xa|xa cách|chia lìa|chia xa|xa nhau
cây viết|cây bút
có khỏe|có ổn|có tốt|có ok
 ok | okay | ôkê | ô kê | ổn | oke | oki | okie
con người|nhân loại|loài người
của cải|tài sản|tiền|tiền bạc|vàng bạc|bạc vàng
cũng không|cũng ko|cũng chẳng
cha ông|ông cha|tổ tiên
chớp mắt|nháy mắt
chê bai|chê cười|cười chê|gièm pha|nói xấu|phê bình|chê
chửi bới|chửi mắng|chửi rủa|trách móc|mắng mỏ|trách mắng|mắng chửi|chửi|mắng
chung thuỷ|chung thủy|chung tình|thủy chung
chua lè|chua lét|chua lòm|chua ngoét|chua ngòm|chua
chanh chua|chua ngoa|đanh đá
chậm chạp|chậm rãi|chậm trễ
cẩn thận|thận trọng|kỹ càng|kỹ tính|cẩn mật|cẩn trọng|kỹ lưỡng
cầu xin|năn nỉ
chết|hy sinh|bỏ mạng|die|quyên sinh|băng hà|chầu trời|chầu hà bá|chầu phật|chầu chúa|quy tiên|tạ thế|ra đi|tịch diệt|toi mạng|chết toi|viên tịch|yên nghỉ ngàn thu
công bằng|công bình|vô tư|phóng khoáng
cô độc|cô đơn|đơn côi|đơn độc|lẻ loi|một mình
cao ngất|cao vút|cao lêu nghêu|cao ráo
cộng đồng|tập thể|bầy đàn
công lao|công sức|công ơn|công tích
chắc chắn|xác định|rõ ràng
chặt chẽ|nghiêm ngặt
chú ý|chú tâm|để tâm|để ý|để mắt
chi tiêu|tiêu dùng
chiều chuộng|cưng chiều|thương yêu|yêu mến|yêu quý|yêu thương
căm ghét|chán ghét|ghét bỏ|thù ghét
ngắn ngủn|cụt lủn|ngắn
chân thật|chân thực
chăm chút|chăm bón|chăm nom|ngó ngàng|săn sóc|trông nom
đảm đang| dam dang
dễ thương|đáng yêu|cute|kawaii|đáng iu|ngoan hiền|xinh xắn
dơ bẩn|bẩn thỉu|nhớp|nhơ bẩn|kinh tởm|tởm
dơ như|bẩn như|nhớp như
dùng|sử dụng|xài
dài thòng|dài dằng dặc|dài ngoằn|dài lêu nghêu
dãn nở|nở nang|dãn ra|phình ra
đất nước|tổ quốc|giang sơn|non sông
đầy ắp|đầy tràn|tràn ngập|tràn trề|đầy rẫy|tràn đầy
đơn giản|giản đơn|rõ ràng|dễ dàng|easy|dễ ợt
đen kịt|đen sì|đen thui|đen ngòm
đen đủi|xui xẻo|bất hạnh
địa ngục|âm phủ|âm ti
đi nhanh|đi mau
đàn ông|con trai|con giai|nam nhi
đang bận|đang mắc|đang có việc
đói meo|đói ngấu|đói bụng|đói lả|đói mờ mắt
đưa tiễn|tiễn đưa|tiễn biệt
đón chào|đón tiếp|nghênh tiếp|đón rước|chào đón
đa số|phần lớn|số nhiều|số đông|phần nhiều|phần đông|chủ yếu
dũng cảm|gan dạ|can đảm|anh dũng|bạo gan|gan góc|gan lì|liều lĩnh
đào tạo|giáo dục|dạy bảo|giảng dạy|chỉ dạy|dạy dỗ
đầu hàng|chịu thua|từ bỏ|bỏ cuộc|buông bỏ|buông tha
đúng|chính xác|không sai|chuẩn
đó|kia|đấy
đòi hỏi|yêu cầu|đòi|mong muốn
đối xử|đối đãi|cư xử
đền bù|bù tiền|bù lỗ
đỏ lòm|đỏ chói|đỏ chót|đỏ ngầu|đỏ ửng
đui mù|mù lòa|đui|mù mắt
gọn gàng|gọn nghĩ|gọn nhẹ|ngăn nắp
giữ gìn|cất giữ
giam cầm|giam giữ|nhốt
già dặn|già đời|già nua|già lão
giảm bớt|giảm sút|rút gọn|rút bớt
gian dối|gian trá|gian lận
giao phó|phó thác
giá buốt|giá lạnh|giá rét|lạnh buốt|lạnh lẽo|rét buốt
hôm qua|hôm trước|hôm kia|hôm đó
hóng|trông chờ|kỳ vọng|chờ đợi|chờ |kì vọng
hòa bình|yên bình|bình yên|an bình
hèn nhát|nhát gan|bạc nhược|rụt rè|e lệ
hiếm hoi|ít ỏi
hờ hững|lạnh lùng|lạnh nhạt|nhạt nhẽo|tẻ nhạt|thờ ơ|nhạt thếch
hiền đức|hiền hậu|hiền hòa|hiền lành|hiền lương|hiền khô|nhân hậu|nhân nghĩa|thánh thiện|thiện tâm|nhân từ
hoảng loạn|hoảng sợ|sợ hãi|lo sốt vó|lo lắng|lo ngại|sốt ruột|bối rối|hoảng hồn|hoảng hốt|hồi hộp|lúng túng|thấp thỏm
haha|hehe|hì hì|hiehie|hie hie|hờ hờ|hí hí|hoho|kaka|ha ha|he he|hh
huhu|hichic|hic hic|hiz|T_T
hư ảo|hư thực|kì ảo|kỳ ảo|ảo ảo|hư hư thực thực
hiện diện|hiện hữu|có mặt|xuất hiện
hạ đẳng|thấp kém
hèn hạ|hèn kém|hèn mạt|hèn mọn
ích kỷ|thờ ơ|lạnh nhạt|ko quan tâm ai cả|vô tâm|vô tình|máu lạnh|lãnh khốc
im lặng|im re|lặng im|im thít|im thin thít|im như thóc
không|ko 
kẻ thù|địch thủ|kẻ địch|thù địch|tình địch|cừu địch
khác biệt|khác nhau
không nói|chẳng nói|không bảo|không nhủ
khô héo|tàn úa|chết khô
khẩu nghiệp|nói lời cay đắng|cà khịa
khó khăn|phức tạp|hiểm hóc|hóc búa|khó nhọc|khó nhằn|hóc hiểm|khó gặm
khổ cực|khổ sở|cực khổ
khô nóng|khô hanh|khô nẻ|hanh khô|nóng nực|nắng nóng|oi ả|oi bức
khổng lồ|to lớn|đồ sộ
khóc lóc|khóc than|mếu máo|than khóc|thút thít
kiên trì|bền bỉ|nhẫn nại
kín đáo|không công khai|riêng tư
khinh miệt|khinh rẻ|khin thường
kiêu căng|kiêu ngạo
kỷ luật|kỉ luật|trừng phạt
khiêm tốn|khiêm nhường
khờ dại|khờ khạo|khù khờ|dại dột|dại khờ
khác lạ|khác thường|kỳ cục|kì cục|kì dị|kỳ dị|kì quặc|kỳ quặc|kì lạ|kỳ lạ|dị thường|lạ lùng|quái lạ|quái dị|ko bình thường|bất bình thường|bất thường|lạ lùng|ngược đời
kết duyên|kết hôn
là như vậy|là như thế|là vậy|là thế 
là gì|là cái gì|là thứ gì
làm sao|làm gì|làm thế nào|làm cách gì|làm cái gì
làm ẩu|làm càn|làm bừa|làm liều
lang quân|ông xã|phu quân|chồng yêu
lạc hậu|cổ lổ sĩ|cổ lỗ sĩ|quê mùa
lặng lẽ|tĩnh mịch|yên lặng|yên tĩnh
lột quần|tụt quần|cởi quần|cởi áo|cởi trần|cởi truồng|kéo áo|kéo quần|lột đồ
lớn lên|lớn khôn|trưởng thành
lúc bé|lúc nhỏ|lúc còn bé|lúc còn nhỏ|lúc nhỏ tuổi|lúc nhỏ dại
loại bỏ|đào thải|thải trừ|vứt
loạn lạc|binh đao|chiến tranh|kháng chiến
lỏng lẻo|lơi lỏng|buông lỏng|buông lơi
liên minh|liên hiệp|liên kết|cấu kết|câu kết|hợp tác
lỗi lầm|tội lỗi|tội tình|tội trạng
lỗ vốn|bù lỗ
lác đác|lưa thưa|lơ thơ|thưa thớt|rải rác
mát mẻ|mát dịu|mát rượi
mập mạp|mập ú|mapdjt|béo múp|béo tròn
mê hồn|mê ly|mê li
mê man|mê mẩn|mê mệt|mơ màng|mê sảng
mừng rỡ|mừng quýnh|hí hững|hoan hỷ|mừng rơn|mừng thầm|sung sướng|sướng rơn|vui sướng
mau lẹ|nhanh nhẹn|chóng vánh
mặt trời|thái dương
mỏng manh|mỏng tanh|mỏng tang
mới tinh|mới toanh
mới lạ|mới mẻ
mặn mà|mặn mòi|đậm đà
mờ ảo|kỳ ảo|kì ảo|mờ mờ ảo ảo
mềm mại|mềm nhũn|nhão nhoẹt|dẻo queo|dẻo quẹo|mềm dẻo|mượt mà|tha thướt|thướt tha|uyển chuyển|yểu điệu
nhanh chóng|khẩn trương|hối hả|tất bật|mau chóng
này nè|này này
ngày qua|ngày trước|ngày kia|ngày đó
nhà thơ|thi sĩ
nguy cấp|nguy hại|nguy hiểm|nguy khốn|nguy nan|nguy ngập
nước ngoài|ngoại quốc|ngoại bang
nghĩa vụ|nhiệm vụ
nhấp nhô|gập ghềnh|lồi lõm
người lớn|người trưởng thành
nhảy cẫng|nhảy cà tưng
nhây|giỡn|đùa
nhìn|ngó|nhòm
nghi ngờ|nghi vấn|nghi ngại|nghi hoặc|ngờ vực
ngủ dậy|thức dậy|thức giấc
ngủ yên|ngủ say
nắng nôi|nắng non|nắng nực
ngây ngô|ngốc nghếch|ngô nghê|ngu dại|ngu đần|mít đặc|ngây dại|ngu ngốc|ngu muội|ngu ngơ|ngu si|ngu xuẩn|tối dạ|ngộc nghệch|đần độn
nhỏ con|nhỏ xác|ốm yếu|gầy gò|gầy dơ xương|gầy yếu|gầy còm
ngọt lịm|ngọt lừ|ngọt sắc|ngọt ngào|ngọt
nôn nóng|nóng vội|vội vã|vội vàng
nông cạn|nông nổi
ổn định|bất biến|bình ổn|định hình
ông trời|ông giời|lão thiên
ồn ào|huyên náo|náo nhiệt
piano|pi-a-no|dương cầm
phản động|phản cách mạng
phá hoại|phá hủy|tàn phá
phồn thịnh|cực thịnh|thịnh vượng
phần ít|thiểu số|số ít|số nhỏ|phần nhỏ
phía bắc|hướng bắc
phía nam|hướng nam
phía đông|hướng đông
phía tây|hướng tây
phấn khởi|phấn chấn|phấn khích
phụ thuộc|lệ thuộc|dựa dẫm|nương nhờ
phụ nữ|nữ nhi|con gái|đàn bà
phải không nè|phải không này|phải không nhỉ|phải không|đúng không|đúng không này|đúng không nè|đúng không nhỉ
phản diện|tà ác
phiền phức|phiền toái|bất tiện|rắc rối
phủ định|bác bỏ
quạu|quạo|cáu|tức|giận
qq|quần què|nani|nà ní
quá khứ|xưa kia|ngày xưa
quên lãng|quên béng|lãng quên|quên
quần cộc|quần cụt|quần cụt ngủn|quần ngắn
quang minh chính đại|đường đường chính chính|chính đại quang minh|ngay thẳng|trong sáng ngay thẳng|đường hoàng|đàng hoàng|ngay thật
quanh co|cong queo|cong vắt|cong vút|ngoằn ngoèo|ngoắt ngoéo|lòng vòng
rứa|ruk|thế|vậy
riêng biệt|đơn lẻ
rườm rà|rắc rối|xoắn não|hại não
rãnh rỗi|thảnh thơi|nhàn nhã|nhàn rỗi|thư thả
rất thê thảm|rất tội nghiệp
ranh ma|ranh mãnh|khôn lỏi|láu lỉnh|tinh ranh|cáo già|khôn khéo|khôn ngoan|láu cá
rậm rạp|sum suê|sum sê|um tùm|xum xuê|xum xê
sum họp|sum vầy|đoàn tụ|đoàn viên
suy tàn|suy vi|suy vong
sáng choang|sáng quắc|sáng trưng
thì thôi|thì mặc kệ|thì không quan tâm|thì đừng quan tâm|thì đừng bận tâm|thì kệ|thì bỏ qua
thông minh|giỏi|khôn ngoan|sâu sắc|trí tuệ|sáng dạ|sáng sủa|thâm thúy
ti vi|tivi|TV
thay mặt|đại diện
tài giỏi|tài hoa|kiệt xuất|xuất sắc|giỏi giang|tài tình|xuất chúng|tài ba
thì thầm|thầm thì|thủ thỉ
thiên thần|angel
thần tiên|tiên trên trời|nhân thần|địa thần
thực tế|thực tiễn
thành quả|thành tích|kết quả
trực thăng|máy bay|phi cơ
tổng thể|toàn bộ|toàn diện|toàn phần|toàn vẹn|trọn vẹn
tổn thương|đau đớn|đau trong lòng|đau tim|đau con tym|đau lòng
thê thảm|thảm thương
thật thê thảm|thật tội nghiệp
thẳng băng|thẳng tắp
tàu hỏa|xe lửa
tập tin|file
tuyệt vời|tuyệt diệu|tuyệt cú mèo|tuyệt mĩ|tuyệt mỹ|tuyệt trần|tuyệt xảo
tiếp nối|thông suốt|nối liền
tin tưởng|tin cậy
trong suốt|trong vắt|trong veo
trẻ em|con nít|trẻ con|bọn nhỏ|bọn trẻ|tụi nhỏ
tiện lợi|thuận tiện
tối tăm|tối mù|tối om|tối mịt
to con|to xác|lớn tướng
trang trọng|trang nghiêm|long trọng
thuận lợi|thuận tiện|tiện lợi
trời đất|giời đất
tươi tốt|tươi xanh|xanh tươi
thiên đường|thiên đàng|cõi niết bàn|paradise
trắng bệch|trắng bạch|trắng bóc|trắng muốt|trắn nõn|trắng phau|trắng tinh|trắng toát|trắng trẻo
ước muốn|mong ước
ương ngạnh|ương bướng|bướng bỉnh|cứng đầu|cứng đầu cứng cổ
vậy thì|vậy là|thế thì|ruk thì|thế là|ruk là
vui vẻ|hạnh phúc|vui sướng|tươi cười|vui|vui thích|vui mừng|thích thú
vẻ ngoài|bề ngoài|hình thức
vẻ vang|vinh quang|quang vinh
vô ích|có hại|bất lợi
vâng lời|nghe lời|nghe theo
vắng lặng|vắng tanh|vắng vẻ|vắng ngắt|đìu hiu|quạnh hiu|quạnh vắng
văn minh|tiến bộ|tân tiến|tiên tiến
vỡ nát|bể nát|đổ nát
nóng vội|vội vã|vội vàng|vội
xe hơi|ô tô
xẹp lép|teo tóp|móp méo|hóp hép
xấu xa|tồi tệ
xanh lè|xanh biếc|xanh lét|xanh lơ|xanh ngắt|xanh rì|xanh rờn
xáo trộn|thay đổi|đổi mới|chuyển dịch|đảo lộn
yếu đuối|yếu ớt|yếu xìu
ý trời|thiên ý|mệnh trời
hi|hello|xin chào|chào